+--+--+--+--+--+
|              |
+  +--+  +  +  +
|  |     |  |  |
+  +   +-+  +  +
|      |       |
+--+  +--+--+  +
|     |        |
+--+--+--+--+--+
